af - Afrikaans
sq - Albanian
am - Amharic
ar - Arabic
hy - Armenian
az - Azerbaijani
eu - Basque
be - Belarusian
bn - Bengali
bh - Bihari
bs - Bosnian
br - Breton
bg - Bulgarian
km - Cambodian
ca - Catalan
zh-CN - Chinese (Simplified)
zh-TW - Chinese (Traditional)
co - Corsican
hr - Croatian
cs - Czech
da - Danish
nl - Dutch
en - English
eo - Esperanto
et - Estonian
fo - Faroese
tl - Filipino
fi - Finnish
fr - French
fy - Frisian
gl - Galician
ka - Georgian
de - German
el - Greek
gn - Guarani
gu - Gujarati
ha - Hausa
iw - Hebrew
hi - Hindi
hu - Hungarian
is - Icelandic
id - Indonesian
ia - Interlingua
ga - Irish
it - Italian
ja - Japanese
jw - Javanese
kn - Kannada
kk - Kazakh
rw - Kinyarwanda
rn - Kirundi
ko - Korean
ku - Kurdish
ky - Kyrgyz
lo - Laothian
la - Latin
lv - Latvian
ln - Lingala
lt - Lithuanian
mk - Macedonian
mg - Malagasy
ms - Malay
ml - Malayalam
mt - Maltese
mi - Maori
mr - Marathi
mo - Moldavian
mn - Mongolian
sr-ME - Montenegrin
ne - Nepali
no - Norwegian
nn - Norwegian (Nynorsk)
oc - Occitan
or - Oriya
om - Oromo
ps - Pashto
fa - Persian
pl - Polish
pt-BR - Portuguese (Brazil)
pt-PT - Portuguese (Portugal)
pa - Punjabi
qu - Quechua
ro - Romanian
rm - Romansh
ru - Russian
gd - Scots Gaelic
sr - Serbian
sh - Serbo-Croatian
st - Sesotho
sn - Shona
sd - Sindhi
si - Sinhalese
sk - Slovak
sl - Slovenian
so - Somali
es - Spanish
su - Sundanese
sw - Swahili
sv - Swedish
tg - Tajik
ta - Tamil
tt - Tatar
te - Telugu
th - Thai
ti - Tigrinya
to - Tonga
tr - Turkish
tk - Turkmen
tw - Twi
ug - Uighur
uk - Ukrainian
ur - Urdu
uz - Uzbek
vi - Vietnamese
cy - Welsh
xh - Xhosa
yi - Yiddish
yo - Yoruba
zu - Zulu 
